000000000074.jpg
000000000113.jpg
000000000086.jpg
000000000036.jpg
000000000074.jpg
000000000036.jpg
000000000241.jpg
000000000201.jpg
000000000149.jpg
000000000113.jpg
000000000136.jpg
000000000086.jpg
000000000241.jpg
000000000241.jpg
000000000257.jpg
000000000294.jpg
000000000257.jpg
000000000260.jpg
000000000308.jpg
000000000308.jpg
000000000308.jpg
000000000315.jpg
000000000315.jpg
000000000885.jpg
000000000315.jpg
000000000885.jpg
000000001296.jpg
000000001584.jpg
000000001490.jpg
000000002153.jpg
000000002006.jpg
000000001584.jpg
000000002473.jpg
000000002261.jpg
000000003156.jpg
000000003934.jpg
000000002473.jpg
000000003553.jpg
000000003934.jpg
000000004134.jpg
000000004134.jpg
000000004395.jpg
000000004134.jpg
